1._.......2.
.2_..11.___.
21_.2.1._2_.
.._2_____._.
.._._...1._1
.._._....._.
2.___2.____.
4......_..12
.42..1._....
.3...___...4
....1_....42
4...._1.3...
3...._____1.
..1.1...._.1
1........_3.
..______3_..
1._3..1_._1.
.._..1.___..
.._..3.1....
.1______....
......1_...1
......._..1.
1.1...._____
.4.........3
.1.1.......1
4.4..1.....4
.1.11.....4.
441..41..1.4
